####################
#  #    #   #   #  # 
## # ## # # # # # ##
#     #   #   # E  #
# # # ########  ## #
# # #     #  ##### #
# # # # # # ##     #
# #   # #    # #####
### ### ######     #
#            ##### #
# ### ##### ##     #
#    #     # #  # ##
### ##### # ### #  #
#  s#   # # # # # ##
# # # # #   #   #  #
# # # # # # # # ## #
# # # # # # # # #  #
# #   #   #   # # ##
####################